1111111111111111111
111110P000000011111
1111000000000001111
1110000011000000111
11C0001111110000011
1000000011000000001
10000000110000C0001
100000001E000000001
1000000000000000001
100000000C000000001
1111111111111111111